2,3,3,3,3,3,3,3,3,3,3,3,3,3,3,3,3,3,3,3,4
5,0,0,0,0,0,0,0,0,0,0,0,0,0,0,0,0,0,0,0,5
5,0,0,0,0,0,0,0,0,0,0,0,0,0,0,6,0,0,0,0,5
5,0,0,6,0,0,0,0,0,6,0,0,0,3,4,0,0,0,0,0,5
5,0,0,0,0,0,0,0,0,0,0,0,0,0,0,0,0,0,0,0,5
5,0,0,0,0,2,3,4,0,2,3,4,0,0,0,0,0,0,6,0,5
5,0,0,0,0,0,0,0,0,0,0,0,0,0,0,0,0,0,0,0,5
5,0,2,3,4,0,0,0,6,0,0,0,0,0,0,0,0,2,4,2,5
5,1,0,0,0,0,8,0,0,0,8,0,0,0,8,0,0,0,0,0,5
5,3,3,3,3,3,3,3,3,3,3,3,3,3,3,3,3,3,3,3,5